AAAPTPAAAAAAAAAAAAAAAAAAAAAAAAAAAAAAAAAAAAAAA
AAAPSPAAAAAAAAAAAAAAAAAAAAAAAAAAAAAAAAAAAAAAA
AAAPPPAAAAAAAAAAAAAAAAAAAAAAAAAAAAAAAAAAAAAAA
AAAPPPBAAAAAAAAAAAABAAAAAAAAAAAAAAAAAAAAAAAAA
AAAPPPPPPPPPPPPPPPPPPPPPPPPPPPPPPAAAAAAAAAAAA
AAAP5PPPPPPPPPPPPPPPPPPPPP6PPPP7PAAAAAAAAAAAA
AAAPPPPPPPPPPPPPPPPPPPPPPPPPPPPPPAAAAAAAAAAAA
AAAPPPAAAAAAAAAAAAAAAAAAAAAAAAPPPAAAAAAAAAAAA
AAAPPPAAAAAAAAAAAAAAAAAAAAAAAAPPPAAAAAAAAAAAA
AAAPPPAAAAAAAAAAAPPPPPPPPPPPPPPPPAAAAAAAAAAAA
AAAPPPAAAAAAAAAAAP2PPPPPPPPPPPP3PAAAAAAAAAAAA
AAAPPPAAAAAAAAAAAPPPPPPPPPPPPPPPPAAAAAAAAAAAA
AAAPPPBAAAAAAAAAAPPPAAABAAAABAPPPAAAAAAAAAAAA
AAAPPPAAAAAAAAAAAPPPAAAAAAAAAAPPPAAAAAAAAAAAA
AAAPPPBAAAAAAAAAAPPPAAAAAAAAAAPPPAAAAAAAAAAAA
AAAPPPAAAAAAAAAAAPPPAAAAAAAAAAPPPAAAAAAAAAAAA
AAAPPPAAAAAAAAAAAPPPAAAAAAAAAAPPPAAAAAAAAAAAA
AAAPPPPPPPPPPPPPPPPPAAAAAAAAAAPPPAAAAAAAAAAAA
AAAP0PPPPPPPPPPPPP1PAAAAAAAAAAP8PAAAAAAAAAAAA
AAAPPPPPPPPPPPPPPPPPAAAAAAAAAAPPPAAAAAAAAAAAA
AAAAAAAAAAAAAAAAAAAAAAAAAAAAAAPPPAAAAAAAAAAAA
AAAAAAAAAAAAAAAAAAAAAAAAAAAAAAPPPAAAAAAAAAAAA
AAAAAAAAAAAAAAAAAAAAAAAAAAAAAAPPPAAAAAAAAAAAA
AAAAAAAAAAAAAAAAAAAAAAAAAAAAAAPPPAAAAAAAAAAAA
AAAAAAAAAAAAAAAAAAAAAAAAAAAAAAPPPAAAAAAAAAAAA
AAAAAAAAAAAAAAAAAAAAAAAAAAAAAAPPPAAAAAAAAAAAA
AAAAAAAAAAAAAAAAAAAAAAAAAAAAAAPPPAAAAAAAAAAAA
AAAAAAAAAAAAAAAAAAAAAAAAAAAAAAPPPAAAAAAAAAAAA
AAAAAAAAAAAAAAAAAAAAAAAAAAAAAAPPPAAAAAAAAAAAA
AAAAAAAAAAAAAAAAAAAAAAAAAAAAAAPPPAAAAAAAAAAAA
AAAAAAAAAAAAAAAAAAAAAAAAAAAAAAPZPAAAAAAAAAAAA
AAAAAAAAAAAAAAAAAAAAAAAAAAAAAAP4PAAAAAAAAAAAA
AAAAAAAAAAAAAAAAAAAAAAAAAAAAAAP9PAAAAAAAAAAAA