AAAAPAAAAAAAAAAAAAAAAAAAAAAAAAAAAAAAAAAA
AAAAPAAAAAAAAAAAAAAAAAAAAAAAAAAAAAAAAAAA
AAAAPAAAAAAAAAAAAAAAAAAAAAAAAAAAAAAAAAAA
AAAA0AAAAAAAAAAAAAAAAAAAAAAAAAAAAAAAAAAA
AAAAPAAAAAAAAAAAAAAAAAAAAAAAAAAAAAAAAAAA
AAAAPAAAAAAAAAAAAA3PPPPPPPPPPPP4AAAAAAAA
AAAAPAAAAAAAAAAAAAPAAAAAAAAAAAAPAAAAAAAA
AAAAPAAAAAAAAAAAAAPAAAAAAAAAAAAPAAAAAAAA
AAAAPAAAAAAAAAAAAAPAAAAAAAAAAAAPAAAAAAAA
AAAAPAAAAAAAAAAAAAPAAAAAAAAAAAAPAAAAAAAA
AAAAPAAAAAAAAAAAAAPAAAAAAAAAAAAPAAAAAAAA
AAAAPAAAAAAAAAAAAAPAAAAAAAAAAAAPAAAAAAAA
AAAAPAAAAAAAAAAAAAPAAAAAAAAAAAAPAAAAAAAA
AAAA1PPPPPPPPPPPPP2AAAAAAAAAAAAPAAAAAAAA
AAAAAAAAAAAAAAAAAAAAAAAAAAAAAAAPAAAAAAAA
AAAAAAAAAAAAAAAAAAAAAAAAAAAAAAAPAAAAAAAA
AAAAAAAAAAAAAAAAAAAAAAAAAAAAAAAPAAAAAAAA
AAAAAAAAAAAAAAAAAAAAAAAAAAAAAAAPAAAAAAAA
AAAAAAAAAAAAAAAAAAAAAAAAAAAAAAA5AAAAAAAA
AAAAAAAAAAAAAAAAAAAAAAAAAAAAAAAAAAAAAAAA

