AAAAPAAAAAAAAAAAAAAAAAAAAAAAAAAAAAAAAAAA
AAAAPAAAAAAAAAAAAAAAAAAAAAAAAAAAAAAAAAAA
AAAAPAAAAAAAAAAAAAAAAAAAAAAAAAAAAAAAAAAA
AAAA5PPPPPPPPPPPPPPPPPPPPA6PPPA7AAAAAAAA
AAAAPAAAAAAAAAAAAAAAAAAAAAAAAAAPAAAAAAAA
AAAAPAAAAAAAAAAAAA2PPPPPPPPPPPP3AAAAAAAA
AAAAPAAAAAAAAAAAAAPAAAAAAAAAAAAPAAAAAAAA
AAAAPAAAAAAAAAAAAAPAAAAAAAAAAAAPAAAAAAAA
AAAAPAAAAAAAAAAAAAPAAAAAAAAAAAAPAAAAAAAA
AAAAPAAAAAAAAAAAAAPAAAAAAAAAAAAPAAAAAAAA
AAAAPAAAAAAAAAAAAAPAAAAAAAAAAAAPAAAAAAAA
AAAAPAAAAAAAAAAAAAPAAAAAAAAAAAAPAAAAAAAA
AAAAPAAAAAAAAAAAAAPAAAAAAAAAAAAPAAAAAAAA
AAAA0PPPPPPPPPPPPP1AAAAAAAAAAAA8AAAAAAAA
AAAAAAAAAAAAAAAAAAAAAAAAAAAAAAAPAAAAAAAA
AAAAAAAAAAAAAAAAAAAAAAAAAAAAAAAPAAAAAAAA
AAAAAAAAAAAAAAAAAAAAAAAAAAAAAAAPAAAAAAAA
AAAAAAAAAAAAAAAAAAAAAAAAAAAAAAAPAAAAAAAA
AAAAAAAAAAAAAAAAAAAAAAAAAAAAAAA4AAAAAAAA
AAAAAAAAAAAAAAAAAAAAAAAAAAAAAAA9AAAAAAAA

