00010000000000000000
00010000000000000000
00010000000000000000
00010000000000000000
00010000000000000000
00011111111111100000
00000000000000100000
00000000000000100000
00000000000000100000
00000000000000100000
00000000000000100000
00000000000000100000
00000000000000100000
00000000000000100000
00000000000000100000
00000000000000100000
00000000000000100000
00000000000000100000
00000000000000100000
00000000000000100000
00000000000000100000
00000000000000100000
00000001000000000000
00000001000000000000
00000001000000000000
00000001000000000000
00000001000000000000
00000001000000000000
00000001111100000000
00000000000000000000
00000000000000000000
00000000000000000000
00000000000000000000
00000000000000000000
00000000000000000000