AAAAAAAAAAAAAAAAAAAAAAAAAAAAAAAAAAAAAAAAAAAAA
AAAAAAAAAAAAAAAAAAAAAAAAAAAAAAAAAAAAAAAAAAAAA
AAAAAAAAAAAAAAAAAAAAAAAAAAAAAAAAAAAAAAAAAAAAA
AAAAAAAAAAAAAAAAAAAAAAAAAAAAAAAAAAAAAAAAAAAAA
AAAAAAAAAAAAAAAAAAAAAAAAAAAAAAAAAAAAAAAAAAAAA
AAAAAAAAAAAAAAAAAAAAAAAAAAAAAAAAAAAAAAAAAAAAA
AAAAAAAABAAABAAABAAAAABAAAAAAAAAAAAAAAAAAAAAA
PPPPPPPPPPPPPPPPPPPPPPPPPPPPPPPPAAAAAAAAAAAAA
49ZPP8PPPPPPPPPPPPPPPPPPPPPPPP3PAAAAAAAAAAAAA
PPPPPPPPPPPPPPPPPPPPPPPPPPPPAPPPAAAAAAAAAAAAA
AAAAPPPAAAAAAAAAAAAAAAABAAABAPPPAAAAAAAAAAAAA
AAAAPPPAAAAAAAAAAAAAAAAAAAAAAPPPAAAAAAAAAAAAA
AAAAPPPAAAAAAAAAAAAAAAAAAAAAAPPPAAAAAAAAAAAAA
AAAAPPPAAAAAAAAAAAAAAAAAAAAABPPPAAAAAAAAAAAAA
AAAAPPPAAAAAAAAAAAAAAAAAAAAAAPPPAAAAAAAAAAAAA
AAAAPPPAAAAAAAAAAAAAAAAAAAAAAPPPAAAAAAAAAAAAA
AAAAPPPAAAAAAAAAAAAAAAAAAAAABPPPAAAAAAAAAAAAA
AAAAPPPBAAAAAAAAAAAAAAAAAAAAAPPPAAAAAAAAAAAAA
AAAAPPPAAAAAAAAAAAAAAAAAAAAABPPPPPPPPPPPPAAAA
AAAAPPPAAAAAAAAAAAAAAAAAAAAAAP2PPPPPPPP1APAAA
AAAAPPPBAAAAAAAAAAAAAAAAAAAABPPPPPPPPPPPPAAAA
AAAAPPPAAAAAAAAAAAAAAAAAAAAAAAAAAAAABAPPPAAAA
AAAAPPPAAAAAAAAAAAAAAAAAAAAAAAAAAAAAAAPPPAAAA
AAAAPPPAAAAAAAAAAAAAAAAAAAAAABAAAAABAAPPPAAAA
AAAAPPPAAAAAAAAAAAAAAAAAAAAAAAAAAAAAAPPPPPPPP
AAAAPPPAAAAAAAAAAAAAAAAAAAAAAAAAAAAAAPP0PPPPS
AAAAPPPAABAAABAAAAAAAAAAAAAAAAAAAAAAAPPPPPPPP
AAAAPPPPPPPPPPPPPPPPPPAAAAAAAAAAAAAAAAAAAAAAA
AAAAP7PPPPPPPPPPPPPP6PAAAAAAAAAAAAAAAAAAAAAAA
AAAAPPPPPPPPPPPPPPPPPPPPPPPPPPPPPPPPPPPPPPPPP
AAAAAAAAAAAAAAAAAAAP5PPPPPPPPPPPPPPPPPPPPPPPT
AAAAAAAAAAAAAAAAAAAPPPPPPPPPPPPPPPPPPPPPPPPPP
AAAAAAAAAAAAAAAAAAAAAAAAAAAAAAAAAAAAAAAAAAAAA